abdominalgia – bolest břicha
achromatopsia – barvoslepost
amenorrhoea – nepřítomnost menstruace
anaemia – málokrevnost
anopia – úplná slepota
anuria – absence tvorby moče
apnoe – dočasné zastavení dýchání
arthralgia – bolest kloubů
atelectasis – kolaps plíce
bradypnoe – znížená dechová frekvence
bronchiectasia – rozšíření průdušek
cephalalgia – bolest hlavy
cholemesis – zvracení žluči
cholestasis – znemožnění odtoku žluče
chromatopsia – abnormální vnímání barev
chylothorax – nahromadění lymfy v cavum pleurae
coccyxodynia – bolestivost kostrče
coxalgia – bolest kyčle
diarrhoea – průjem
diplopia – dvojité vidění
dorsalgia – bolest zad
dysmenorrhoea – bolestivá menstruace
dysopsia – obecný termín pro poruchu vidění
dyspnoe – dušnost
dysuria – bolest při močení
enterostasis – stagnace tráveniny ve střevě
eupnoe – normálné dýchání
fluidothorax – všeobecný termín pro označení pleurálního výpotku
galactorrhoea – abnormální produkce a výtok mléka
galactostasis – zadržování mléka v mléčných žlázách
glykorrhachia – množství glukózy v mozkomíšním moku
glykosuria – sladká moč, přítomnost glukózy v moči
haematemesis – zvracení krve
haematoma – krevní masa neboli modřina
haematuria – krev v moči
haemolysis – rozpadnutí erytrocytů
haemophilia – tendence krvácet
haemoptysis – vykašlávání krve z dýchací soustavy
haemorrhagia – krvácení
haemostasis – zastavení krvácení
haemothorax – nahromadění krve v cavum pleurae
hemianopsia – slepost poloviny zorního pole
heteropsia – nerovnaké vidění očí
hyperemesis – silné mnohočetné zvracení
hyperopia – dalekozrakost
hyperpnoe – zvýšená hloubka a frekvence dýchání
hypopnoe – plytké dýchání
leukorrhea – bílý vaginální výtok
lymphostasis – zhoršení nebo zástava lymfatické drainage
metastasis – objevení novotvaru na dalším místě
myalgia – bolest svalů
myopia – krátkozrakost
nephrectasis – rozšíření pelvis renalis pro obstrukci
neuralgia – nervová bolest
nocturia – časté močení v noci
nyktalopia – zhoršené vidění za šera nebo tmy
odynophagia – bolest při polykání
oliguria – snížená tvorba moče
orthopnoe – nutnost dýchat v sedě nebo stoji
otorrhoea – výtok z ucha
pertussis – černý kašel
photopsia – pocit záblesků bez světelné stimulace
pleurodynia – bolestivost pohrudnice, poplicnice
pneumothorax – nahromadění vzduchu v cavum pleurae
polyuria – nadměrné močení
presbyopia – stařecká dalekozrakost
proteinorrhachia – nález proteinů v mozkomíšním moku
proteinuria – přítomnost nadměrného množství proteinu v moči
pyorrhoea – výtok hnisu z dásní
pyothorax – nahromadění hnisu v cavum pleurae
pyuria – hnis v moči
rhinorrhoea – vytékání "soplu" z nosu
sialorrhoea – nadměrné slinění
steatorrhoea – přítomnost lipidů v stolici
tachypnoe – zvýšená dechová frekvence
teleangiectasia – rozšíření kapilár
uraemia – vysoká hladina močoviny v krvi
urostasis – retence moči
venectasia – rozšíření žil
venostasis – zastavení žilního odtoku
